#####################################
##             # ##           ## ## B
# # ### ### ## # # ## #  # ## # ##  #
#   # # #    # # # ## ###  ##  ##  ##
# # # # # ## #  #     ##    #### # ##
# #   # ############ ### #    ## # ##
# ### #       ## # #   #  # # #  # ##
#    ##### ##       ## #  # # ## # ##
# # ### ###########  # # #  # # ## ##
# #   #     #        # #  # # # ## ##
#  ######## # # ###### ##  #    ## ##
## #    # # # # #    # # # # ## ## ##
## # ## # #   # #### # ##  ## ###  ##
#A   #      ##         #          ###
#####################################
