#############################################################
####### ############# ####### ##    ###    ## ###########   #
###    #       #     #   #   ####  ##   ##  ##   #        #B#
### # ## ### # # ###   #   #  ##  # ##   ##  ### #  ##### ###
### #  #  ## ##   # #    #### ##  ## ##  ##  #      ###  #  #
### #### ###  ##  #   # ###   ## ##   ##   #   # ## # #   ###
### ##    ### ##  #  #### ###  ### ##   #   ###  ## # # ##
###  ##  ####    ## ###   ##      ##  ##  # ##   #    ### #
### ####### ## # ## ## ####   ###    ##  # ### #  ###### ###
### ##  #      ## # # ####   ## ##  #     #   ##  ## ## ##
### # ##  #  ## ##   ##   ## # ##  ## #  ###  ##   ##  ##
###   ##   ###   ##   # ##   #        ##  ## ##    #### ###
###  ##  ##  ## ## #   ####  ##  #  # ##  # ## ##  ######
### # ##  ### ### # ## ##  ##   ####   ##  ##   ## ##  ##
#### ## #  ##  # ##   ##   ### ##   ##  #  ###    #   #
####   ## #####  ###  ## # ## ##   ## ## ##  ##  ## ######
###  #    #    ###  ##   # ##  ##  ## ##  ##     ##  ## ###
### ## #### # ### ## # #   ##  ##   ##    ##  # ##   ## ###
# ##   ##   ##   # ## #     #  ## ##   ## ## # ## ## ## ###
#    ## ##      #   #   ###   #      # ##   ##    # ##  #
#### A##   ### ## #   #    ##   #  ##  ###   ### ##    #
#####    ### #   ## ## ### ##  ##   ##  ##       # # #####
#############################################################

