#######################################################
#    ###    # #               #   #     # #          B#
###      #      ##   ########   #      #  # ###       #
#   ###################   #  #  #  ###  #   #  #      #
# ####                # # # #    #    # ## #  #  ## # #
# ################### # # # #  #  ######  #  #  ####  #
#                     # # # # #          ##  #    ## ##
##################### # # # #   ##  #### # #  # #  # ##
#   ##                # # # # ## ##   #    ## # # #  ##
# # ## ### ## ######### # # #  #    #           # ## ##
# #    #   ## #         # # #   #### ##### ### #  #  ##
# # ## ################ # # #  ##   #     #  ##  #   ##
### ##             #### # # # #   ##  # ## #     # ####
### ############## ## # # # ##  ##   # #  # # #       #
###             ##    # # # # #    #       ##  #  # ###
###### ######## ####### # # #    ### #  ###     ## # ##
###### ####             #             ## #   # #   # ##
A      ######################  # # #        #     #  ##
#######################################################
