##################################
#A    ##         ##   #         ##
# ### ## ######## ## ### ###### ##
# ##       #    #    ##    #     #
# ## ##### # ## ####### ## ##### #
# ##    #  # ##       # ##    #  #
# #######  # #  ##### # #######  #
#      ##                    ##  #
### # ###### ## ######### ##### ##
#    #    #  ##    ##       ##   #
### ###### ###### ### ##### ## # #
###        #      ##    ##  ## # #
###### ## ####### ## ###### ## ###
#    # ##      ##    ##     ##   #
# #### ## #### ## ## ## ##### ####
# ##   ## ##      ## ##     #     #
# ## ### ############ ########## ##
#                                B#
